1
46
XXXXXXXX
XS  XXSX
XX  B  X
XXBXX  X
X  XXBXX
X  B  XX
XSXX  SX
XXXXXXXX
2
26
XXXXXXXX
XS   B X
XSB  X X
XSX B SX
XXX X XX
 X B  X 
 X  XXX 
 XXXX   
3
46
 XXXXX  
XX   X  
X BV XXX
X SBS  X
X BSB  X
X SBS XX
X     X 
XXXXXXX 
4
66
    XXXX
  XXX  X
XXXS B X
XSSB B X
XS  BX X
XBXS   X
X   X  X
XXXXXXXX
5
26
 XXXXXXX
 X     X
 XSXBB X
 XSSS XX
XX BXBXX
XSB B SX
X      X
XXXXXXXX
6
44
        
 XXXXXXX
 XS S SX
 X BBB X
 XSB BSX
 X BBB X
 XS S SX
 XXXXXXX
7
43
XXXXXXXX
XS    SX
X XSBX X
X BB B X
X B BS X
X XBSX X
XS    SX
XXXXXXXX
8
46
 XXXXXXX
 XS S SX
XX B B X
X BSVSBX
X  BSB X
XX  V  X
 XXX  XX
   XXXX 
9
15
 XXXX   
 X  X   
XX  XXX 
X BS  X 
X SBV X 
X  SB X 
XXX  XX 
  XXXX  
10
64
XXXXXXXX
XSS    X
XSSB B X
XBXBBBXX
XSSB B X
XSS    X
XXXXXXXX
        
11
36
XXXXXX  
X   XXX 
X BSS X 
X BSS X 
X BBSXX 
XXX BX  
  X  X  
  XXXX  
12
63
    XXXX
  XXX  X
XXX    X
XS  BX X
XSSB B X
XXXS B X
  XXX  X
    XXXX
13
31
XXXXXXX 
X     X 
X B B X 
XXBB XX 
 XSSSSX 
 XXXXXX 
        
        
14
31
XXXXXXX 
X     X 
X BBB X 
XXSSSXX 
X SVS X 
X B B X 
X  X  X 
XXXXXXX 